|-----------------------------------------------------------------------------|
|                                                                             |
| |--------------------------|        |-----------------------|               |
| |......................H...|        |........../........9...|               |
| |..............E...........+########+..............6.....D..|-------|       |
| |..........................|   #    |................L.......@......|--|    |
| |..........................|   #    |..................................|--| |
| |----------+---------------|   #    |----+----------------|...............| |
|            #                 #############                |.........4.....| |
|            #                 #     |-----+------|         |...............| |
|            #                 #     |...1L....4..|         |3..............| |
|            ###################     |.L..8.....0.|   ######+...............| |
|            #                 #     |....L...7L..|   #     |.....5.........| |
|            #                 #     |-----+------|   #     |--------+------| |
|  |---------+-----------|     #           #          #              #        |
|  |..E..................|     #           #          #         |----+------| |
|  |.....................|     ########################         |...8.6.....| |
|  |H......W........H....|     #           #                    |...........| |
|  |.....................|     #    |------+--------------------|W..........| |
|  |........H............|     #    |....................W.................8| |
|  |0..3.................+##########+..........L.......O..L...L...H.........| |
|  |....O........5......7|          |.......................................| |
|  |---------------------|          |---------------------------------------| |
|                                                                             |
|-----------------------------------------------------------------------------|